Gen	Gen
Ex	Exo
Lev	Lev
Num	Num
Deut	Deu
Josh	Josh
Judg	Judg
Ruth	Ruth
1Sam	1Sam
2Sam	2Sam
1Kings	1Kin
2Kings	2Kin
1Chr	1Chr
2Chr	2Chr
Ezra	Ezr
Neh	Neh
Esth	Esth
Job	Job
Psa	Ps
Prov	Prov
Eccl	Eccl
Song	Song
Is	Isa
Jer	Jer
Lam	Lam
Ezek	Ezek
Dan	Dan
Hos	Hos
Joel	Joel
Amos	Am
Obad	Oba
Jonah	Jona
Mic	Mic
Nah	Nah
Hab	Hab
Zeph	Zeph
Hag	Hag
Zech	Zech
Mal	Mal
Matt	Mat
Mark	Mar
Luke	Luk
John	John
Acts	Acts
Rom	Rom
1Cor	1Cor
2Cor	2Cor
Gal	Gal
Eph	Eph
Phil	Phil
Col	Col
1Th	1Ths
2Th	2Ths
1Tim	1Tim
2Tim	2Tim
Titus	Tit
Philem	Phlm
Heb	Heb
James	Jam
1Pet	1Pet
2Pet	2Pet
1John	1Jn
2John	2Jn
3John	3Jn
Jude	Jud
Rev	Rev
